222222222222222222222222222222222222222222222222222222222222222222222222
211011011011000101111111101111101111110111111111111111111011100011111112
201111111101111111101101011101111111011100010111010111110011110111111102
211011000111111111111100111100001101111011110111000111111101111111111102
210111110111011101011101101111111111101110111102111111111100111011111112
210111110111111122222222211111111111100111122222222211101031111111111112
210101010111112222222222222101111011010111222222222221001131011111101002
210101010011100000012222222111110000000012222222222213111131111100111012
211011110011100000h02222222211111110110010212223333333333333331011111112
210111100111100000002222222111100111010001022333333333333333331110111112
201011010000000000000000000000000000000003333333333333333333333311111112
211011110011100020002212111101000110101011333333333333333333333331001002
201110110111100010002111111101001110000113333333333333333333333333111112
211000110111100010000011011101011110111133333333333333303333333333311112
2111111001111000100011011011011111001011333333333333300000wwwwwww3311002
2011101101001000000010110111001111111101333333333333000000033333w3301112
2111100000000000000011111111010000000013333333333330000A00C03333w3331112
21010v0000000000000011011111000110211110333333333333000000033333w3311112
2111000000000000000011101111012222222221333333333333300000wwwwwww3311102
210100010222200020001011100101222222211233333333333333303333333333311012
200100020222200020001111011202211212221123333333333333333333333333110102
211100010222200020001101111202222222222212333333333333333333333331011112
201000010212200010001001002202202222222222233333333333333333333311111112
201100010011200010001100111202202222222222111333333333333333331111111112
210100010111100000000000000000000000000003333333333333333333110111110102
211100010111000000001110111112202000002221113111111113011131110101011112
200100010011100010001111101011202221222111113111101101111131010111111112
211100000000000010001111111111001120111003333101111111111131110110110112
211100000000000010001111101110101111110011110111111110111101111111111112
201100000000000000000111111111111111111111110101010101111101110110100102
210000000000000000000000000000000000000000000000000000000000000000000012
21100000000000c000001111100100000000011110010011111111111101111011111102
211000000000000011010111101101010111111111111111100001011100111110111102
210100000000000011111001111100111011111100101111010111101111101011101112
211111000101110111111001101110101011110011111101011111110101110111111112
222222222222222222222222222222222222222222222222222222222222222222222222
