22222222222222222222222222222222222222222222222222222222222222222222222222222222222222222222222222222222222222
22333333333333333333333333333333333333333333333333333333333333333333333333333333333333333333333333333333333322
22333100110000000000010000000100000000000000000000000033000000000000000000010001000000010000000000000000033322
22333001000220001100001100001000100000000110000000000033001110000000000000001100001110001101100001000010033322
22333101002222210111000010000000011000000000000000003330000000000000001100000000111000100010010010001110033322
223330102022c2200000010001110010000000100000000000033300001010010000000000001001000010011001001000011000033322
22333000100002200110100000001001100000011000100003330000000000000100000000110010001101000101000010110010033322
2233311001110001001010000010010000000000000003333300100001000000000000110100010010000010v100011001000110033322
22333000110110100100011000010000001100000000000000000110000010000000000000000001001100011100100000001001133322
22333000000010000010000001000010000003333333000000000000000000110000000000033300100111000001101010010010033322
22333220002001111101101000011100000333333000000000010000000000100000000033333330000001111111001001000100033322
22333002002000000000000101000000003333330011111101100000110000000000003333333333000000000000001100100100033322
22333000011000000000001000000003333333000000011110000000010000000000033333333333333333001001100000010010033322
22333001010000001001100000033333333000000000100011100020000010001000000033333330003333330000011010001000033322
22333000000000101000000003333330000000000000000000000222000001000011100000033330103333333000000100000000033322
22333000000021000100000333330000000000000011000010000002220000000000010000033330003333333330000000000000033322
22333200000200000000333333333333300022220001111111000022000000002200000000000033333333333333300000011000033322
22333000022000000033333300000333330000022200111000002220000002110000020000000022003333330000000100000000033322
22333000000000003333330000000000033330000000000000222000000221110022002000022000000000000000000000000100033322
22333002200003333333000000000000000033333000000022200000000000000000000000002220000000202000000010000010033322
22333222000333333000000000100000001000000000222220000000000002121111002202000000000201111101100001000000033322
22333333333333330000000000010000000010000000000000000000000000000220000000002220000011000101110000000000033322
22333333333333333300000000000100000000000000000001111000010000000011100020000000011110011101111000010000033322
22233333000000003333333300000000000000100000000111121110002200000000222000022000200110000001110000001100033322
22333000000000000000000333333333330001000010000000111000000200000000000000200000000001111111110000000000033322
22333000000000000000000000000000000010000000000110000000000020000000000000000222000220020200000200000000033322
22333000000000000111111111100000001100010001111111000000100000011010000110000000000000000022200000000333333322
22333000000011111111100000001111111110111111111000000000000000000000011111000000020002002000200000333333333322
22333000001111000011111000111110000011111100000000111000000000000000000110000000000002202000000000333C33333322
22333000111100000000111100000111111001000001100001000000000000101000000010033333300000000000000003333333333322
22333000000000000000000000000000000000001000000000000000000100000001000000000003333000000000333333333333333322
22333000002220000022222000000000000001111111100010001001001110000000000000010000003333333333300033300100033322
22333000000022222220002222002200000000000001111111100000011111100000000000000000000333333000000000010000033322
22333002222222000000000220000022000000000000111110000000000100000011000000000000333333001000001111111000033322
22333000000000002200000000002002000110000000000110000000100000000001000000000333333000100000100001111110033322
22333000000000022002200010000200000001100010110000000000000000000000000011000333300000000000000000000000033322
2233300000000222002000101100000101000011000000000000000001100111111100000010000000wwww0wwww0wwwww0wwwwww033322
223330000222220000001000010100001000000001110033333330000000001111111100003330www0w0000ww000000000w00000033322
223330002200000110011000000010000010100010000000003333333300000000000001033000w000w0wwwww0wwww0www00w0ww033322
22333000000010001100110100000011100000110000011000000000333333000000333330www0w0w0w0wwww00www0ww0000wwww033322
2233300220010101h000010110010100000000000000100000111110000333333333333300w000w0w0w0000w0w0000000ww00000033322
2233300022000011111001000010000000200010000000001111111110000000333333000ww0ww00w0w0ww0w0w0wwwww000wwwww033322
2233300002002001001011100100011000022000100100000000000000000033333000000w00ww00ww00ww0w0w00000Aww000000033322
2233300200000100100001110001000100000010000011111111110000003333300000011w0w0000000ww0000wwwwwwwww0wwwww033322
223330222022000100100000011100011002200011111110000000000333333300001100ww0000w0ww0ww0ww00000000ww000www033322
22333000000000100011100010010000100000100011100000000033333333000000000000w0www0w00ww000w0w0www00www0www033322
223330002000000101000000000001000001000000000100000333333330000010001100www00ww0ww0ww0www0w0wwww0www0www033322
22333002220000000000000000000000000000022000000033333333000000000100000000001000000000000000000000000000033322
22333333333333333333333333333333333333333333333333333333333333333333333333333333333333333333333333333333333322
22222222222222222222222222222222222222222222222222222222222222222222222222222222222222222222222222222222222222
