11111111111111111111111111111111111111111111111111111111111111111111111111111111111111111111111111111111111111
10000010002001000000000000000000300300001000011003100000000010000010001000000001100300000000100000030200001001
10000010000000332000000100010011300301000000020000000022010002010000300002001000200000003003000333010010000321
10300201030000000100000000000300300030200000002300001001000000000000000000100000100030000000000020000022010001
10130002200200000000020000200000000000000000000200010000010210000002000000300000100000000002021013300010030001
120200020020c0010000000200000000000001000000000000000000013302000001020000000030030000000310020010000000000031
10000010200010200000100110001000000300300010000000000001000000000000302001020000000013000000210000020000000011
10100020000000200000033100000000000202000000000102000002000000000011200032010001103000000202000001000030200201
10000002300002000000001100000020002200000000000033100010003000000000000300200030020200000000001020010000020001
10200002103000000000000300000000031021000010003300000000000000000000011000000020000320300000100003000021000021
10000000003100021000000000030000000000000000010000000030000000000000000000000000301000000030200000000000010001
10000000000000002000000101000000001310022000000100000010000001000301010002000002000000100010020000020110300011
11000000000303000000200020000110003001000010000000000100203220000000000000022021001000000000000000003000000231
10010113223000000100003030000030000100000201030300000001120003000110000000000032000100000000000100000000000001
10131110010110000000000100010002010133000000000000000000000000001000000101100001000000000003000000310020030101
10000010000002100300002000001000130000200000300003000000000320001003032100000000010010000100000100200011200201
10000200000100000000002000000003020000001110010002001000021023030000020110000000000000200000010000100000020331
11110302010320000000201010000000010003000200000301000210000000000300030000100003020000110000000030000000000001
10001330003000012000000000130000010310000000000000030000100100310000000010000000100002000010013001011100003001
13330000020100101000000030033010000000003000110000202010003300300100000010000000001002000000000011103300003001
10000000000303100020000000000020300000000010000000002300000000000000000000003000000300000001002030000001001001
10300001000000001010000000003000000000000300310003000000200010000030000000000001000023000000000000000000000001
10000100000030030100000300000000000000031000002000100100320000100000001000000020000012300000000000301002000001
10020030000002203000300000030000030030000001000000001001000000300000002210100020002030000100000100010310330001
10000000130000100000000000000000300000002001003000031000000000001000000000200102000010030000000000000000000001
10013000000000002000000002000033002000101000000001021030002000000000000130100300100000000000100100010000000001
100000000020000001010022000001000000000030000012000000302300300000010000000001000000121000033000wwwwwwwwwwww01
101000013000310000000030020001000000002313001010011000130310000000002000010000030000003000000100w0001000003w01
101000003000200000000100001000001000000300000002010000010003000000010010000000002002300000000010w0103000010w01
110110300003030010000220000010001000010000211002103203000010301003000030002000010000111001201000w0000000000w01
100000000120201000030200000000002030001000000030020030001000000330000020010100000000001000100022wwwww0wwwwww01
10200000230300020001010000000000110000003000000101000030000103001000003000303020200300000000000000000000001001
10010000100210300011000103000023100000000000100000000000000000210000023033001003010003000000000300000020000001
10300010000010030000000000300000000000001000300100003000103022000300110000000000200001000000000000002000000001
10000000003300020300000000020000000020100130000000001000000000000200303102001000013000000000300000000000002001
10010300000000000000000100002000000330000000010100210000201030000210000101000000003030000331001000100000000001
13000003000000000000000000000000000100000000000000003200021031020000000000030000000310000000000011000000020001
10000010000000000000000200000020010032000010000300020000011000002000000000310000100032010000000210000000000031
10000022000000000000000000003000000001000001000000000010000000000010030003000000000230300000000000000000000101
10000000000000000000000000000000000000000000000000000000000000000000000000000000000000000000000000000000000001
1010301000000000h000000020201000020101001010000000101000200000003000000000030020000100300000021010002001001211
10000000000000000000000020010000010000000012000000000100001333000000000003000000322000210010000000002000200011
10010010000000000000000001021000002000021000000200002000300000002031000030000010100310000010101A00330300003001
10000100000000000000000003000100000110002100000100010010000000100000020100100000010001000000000000000000000001
10000203000000000000000002000000000300002000010000000000300002003000001033000001000000002001000000000030300021
11103100000000000000000001000000031000001001000200300010100000020000003000300000000000100000010000000011000011
10000000000300030030103300000010000030001300000000100310012100000000010000100000000001010000002130000000200001
10000000030200000000000030002000020002000000100002001010100300000100202000102000000201200100010030030020010001
10013010200000000001103300100200000000330000020000000000000000010000200010000000000002001100300000000000200001
11111111111111111111111111111111111111111111111111111111111111111111111111111111111111111111111111111111111111
